姓氏	男名	女名
familyname	man	woman
支	邑	斌
余	乾	莹
贲	绯	妍
赵	擎汉	鸣凤
慕	豪英	不二
巫	剑愁	一一
太叔	一笑	大娘
方	逊	茗
诸	蹇	颖
元	涔	嫣
邓	酬海	无颜
孙	成败	千愁
萧	冥幽	摇伽
乔	天问	二娘
尉迟	紊	敏
柳	剑	盈
朱	臻	芫
卜	复天	莫言
单	忘幽	稚晴
李	士萧	菲鹰
姚	山河	三娘
燕	凡	莆
东方	鞯	樱
叶	珩	凤
尤	严青	无色
顾	成危	英姑
杭	中道	冰颜
周	仇天	四娘
邵	嵩	姝
牧	达	荧
诸葛	鹤	珠
唐	不斜	亚男
许	成风	若颜
穆	道天	无心
洪	一斩	涟妖
郑	豪	彤
狄	烙	萤
侯	鞅	洙
夏侯	不可	素阴
吕	成仁	飞飞
尹	道消	藏鸟
包	不二	虔纹
王	裘	桐
宋	冥	莺
秋	霸	竺
欧阳	不正	若男
曹	无施	妙芹
堪	道罡	若冰
诸	无剑	若魔
冯	匪	芝
庞	惮	瑛
仲	寇	萝
皇甫	无声	灭男
严	不斜	珊珊
汪	不凡	嫣娆
左	断天	绾绾
陈	戾	芷
叶	雍	璎
宫	博	翠
上官	百招	高丽
华	靖仇	如雪
祁	不尤	唯雪
石	远侵	艳血
卫	瑛	姿
阮	鑫	芙
宁	匕	萃
司马	千万	妖丽
陶	若风	雪一
禹	千筹	菲音
崔	一刀	绝音
蒋	铭	茈
郦	靖	芾
仇	弼	柔
司空	随阴	三颜
姜	若剑	茗茗
屈	断秋	如冰
吉	碧空	血茗
沈	霆	涫
童	紊	湘
祖	碧	沁
鲜于	一手	代男
柏	若之	荧荧
项	断缘	如娆
钮	仇血	凤妖
韩	驳	秀
颜	钧	襄
武	捕	芹
长孙	三毒	踏歌
章	亿先	赛凤
董	道之	如音
龚	万声	若血
杨	疾	蓉
白	隶	香
轩辕	败	衫
潘	三德	芙蓉
粱	人达	柏柳
程	剑心	一曲
秦	万天	雪冥
韶	威	青
闾丘	沅	玲
彭	悲	珊
罗	一德	雁开
荣	人英	艳一
何	剑成	灵煌
郜	送终	冰姬
东郭	祥	卿
昌	翎	灵
席	羿	琳
荀	老九	东蒽
施	人杰	宝川
蔺	剑封	宫苴
令狐	绝山	绝音
阎	誉	清
孔	戎	绫
徐	储	莛
淳于	老五	沉鱼
酆	人雄	宝莹
贾	万言	涔雨
於	绝义	邪欢
魏	枫	惠
邱	擎	翎
南宫	靳	葶
鲍	老四	落雁
江	元龙	不弱
惠	绝悟	太君
戚	沧海	老姆
闵	凛	荟
百里	荆	丝
岑	汲	芮
黎	十三	凡英
甄	成威	不惜
谢	绝施	莫茗
樊	万仇	黎云
单于	涛	筝
雷	丑	姒
鄂	邴	赛君
魏	如豹	可仁
邹	成协	莫英
温	乘风	凤凰
宇文	万怨	真
汤	卿	苠
夏	坤	闭月
家	糜	可兰
卓	连虎	朝雪
凌	不评	一寡
赫连	乘云	贞
滕	万恶	绮
高	豁	羞花
封	耷	可燕
窦	松	老太
霍	似狮	颜演
乐正	老三	珍
聂	世开	淇
蔡	恶天	不愁
宓	焱	可愁
翟	磬	茹嫣
虞	井	幻然
子车	大楚	宛
廉	广山	荠
田	剑鬼	盛男
符	灭龙	可冥
苏	虔	丹妗
柯	函	幻悲
慕容	富	娩
毕	定帮	琦
万	不言	青荷
刘	远锋	梨愁
范	剑身	缘郡
莫	契	幻雪
司徒	翰	莞
郝	乌	衣
支	伟帮	清涟
景	追命	不悔
鲁	远望	冥茗
缪	无敌	幻嫣
阳佟		菀
史	罡	沂
咎	遥	一兰
詹	焦	不乐
韦	大有	溪灵
宗	难敌	葵阴
归海	远山	素
邬	半鬼	苡
管	鸿	如花
钱	萧	起眸
苗	奎	惋清
宣	高烽	灭绝
司空	难破	愫
安	广缘	怡
卢	行天	聋五
吴	胜	惋庭
方	嚣	太英
郁	稀	夜阑
西门	自中	涑
常	难摧	悒
经	天与	绣连
张	浩天	香芦
任	鹰	太清
嵇	骁	藏今
左丘	班	兰
于	天川	芳
房	难胜	金连
喻	天抒	飞凤
袁	天寿	善斓
邢	卿	幻姬
伯赏	鲂	澜
傅	仰	芸
裘	大开	大凄
俞	德地	无春
柳	天奇	善愁
向	无血	茹妖
巫马	城	蓝
赫	剑	笙
费	伊	傻姑
唐	傀儡	紫烟
裴	德天	善若
谷粱	半仙	香魔
连	聋五	斓
解	康	忻
纪	筮	蛟凤
薛	栾	双双
陆	羊青	嫣然
公西	世平	魂幽
齐	一鸣	纹
应	如花	芯
骆	阁	莹芝
贺	勒	汝燕
翁	厉	阑悦
公冶	牛青	藏花
伍	世德	雯
丁	文龙	紫
车	三问	中蓝
孟	穆	玉兰
段	炳	阑香
濮阳	戎	妖妖
	开山	若
	世立	茈
	元正	太兰
	非笑	婷冉
	扬	岂愈
	斩	一凤
	天德	弱
	中恶	芷
	浩阑	寡妇
	蓝血	秋尽
	垣	紫伊
	颤	芸遥
	铁身	萍
	延恶	颜
	士晋	外绣
	无招	凤灵
	师	清炎
	孱	行云
	老黑	颦
	百川	艳
	铸海	不平
	无极	媚颜
	翼	清涟
	续	舞仙
	半邪	婴
	世倌	雁
	人龙	毒娘
	鬼神	问晴
		苑睐
	秋	小小
	岩	
	半山	
	连碧	
	伯云	
	满天	
	傥	
	奄	
	一江	
	岱周	
	老头	
	飞扬	
	乞	
	箴	
	十八	
	行恶	
	剑通	
